aboil |Tính từ & phó từ $đang sôi
abrogative |Tính từ $bị hủy bỏ
absquatulate |Nội động từ $trốn chạy
acescent |Tính từ $hoá chua; chua
bedtime |Danh từ $giờ đi ngủ
bill |Danh từ $(từ Mỹ check) hóa đơn, giấy tính tiền $tờ quảng cáo, yết thị
Breakfast |Bữa sáng
clearway |Danh từ $đường cấm xe đỗ
consubstantiality |Danh từ $tính đồng thể chất
contractibility |Danh từ $tính có thể thu nhỏ, tính có thể co lại
crumpy |Tính từ $dễ vỡ; mềm yếu
crutched |Tính từ $đi nạng; chống gậy
cryolite |Danh từ $(khoáng chất) criôlit
cryptologist |Danh từ $người chuyên về mật mã
ctenosome |Danh từ $(sinh học) nhiễm sắc thể hình lược
dotted |Tính từ $có nhiều chấm
downland |Danh từ $vùng đất thấp
employable |Tính từ $có thể được thuê làm
employee |Danh từ $người làm, người làm công
employer |Danh từ $ông chủ
enacting clauses |Danh từ $điều khoản (của một đạo luật...)
encephalisation |Danh từ $sự hình thành bộ não
farmland |Danh từ $đất chăn nuôi, trồng trọt
foxship |Danh từ $tính gian xảo
housewifely |Tính từ $nội trợ
hunkers |Danh từ (số nhiều) (khẩu ngữ) $hông
hurdler |Danh từ $vận động viên chạy vượt rào
hurdling |Danh từ $môn chạy/nhảy vượt rào
hurds |Danh từ, (như) $bã đay gai
hybris |Danh từ $quá kiêu căng
hygrograph |Danh từ $máy ghi độ ẩm không khí
magnetostatics |Danh từ $từ tĩnh học
maharaja |Danh từ $hoàng tử (ấn Độ)
otherwhile |phó từ $vào lúc khác
oubliette |Danh từ (cũ) $hầm ngục tối
outborn |Tính từ $sinh ở nước ngoài
outclimb |Ngoại động từ $trèo giỏi hơn
passiontide |Danh từ $hai tuần lễ cuối của tuần chay
patagial |Tính từ $(động vật học) thuộc mảng dù lượn
pauperize |Ngoại động từ $bần cùng hoá
pawnshop |Danh từ $tiệm cầm đồ
semimetal |Tính từ $nửa kim loại
semisweet |Tính từ $ngọt vừa
softy |Danh từ $(thông tục) người nhu nhược, người ẻo lả
soilure |Danh từ $vết nhơ
solute |Danh từ $chất tan
unbesseming |Tính từ $không thích hợp
unbreathable |Tính từ $không thở được
uncap |Ngoại động từ $bỏ mũ (để chào) $mở nắp
uncheerful |Tính từ $không vui; buồn; rầu rĩ
uncleanliness |Danh từ $sự bẩn thỉu, sự nhơ nhuốc
unclick |Ngoại động từ $(kỹ thuật) thả ngàm hãm (bánh xe răng cưa)
uncompliant |Tính từ $không hay chiều $không phục tùng
well-balanced |Tính từ $có tinh thần ổn định
well-made |Tính từ $phát triển cân đối (người)
westland |Danh từ $đất miền tây
whilere |phó từ $(cổ) cách đây không lâu; mới đây
whity |Tính từ $trắng nhạt
worldwide |Tính từ, Phó từ $khắp thế giới
zipper |danh từ $khoá kéo (ở áo...)
zoo |Danh từ $vườn thú; sở thú
